                                                                                                 
                                                                                                 
                                                                                                 
                   #######################################################################       
                   #                    #                            #                   #       
                   #          B         #                            #                   #       
                   #                    #                            #                   #       
                   #                    #                            #                   #       
                   ################## ####################################################       
                   #                    #                            #                   #       
                   #                                                 #                   #       
                   #                    #                            #                   #       
                   #                    #                            #                   #       
                   ################################## ######### ##########################       
                   #                    #                            #                   #       
                   #                    #                                                #       
                   #                    #                            #                   #        
                   ################################## ############## ########## ##########        
                   #                    #                                                #        
                   #                    #                            #                   #        
                   #                    #                            #          A        #        
                   #                                                                     #        
                   #                    #                            #                   #       
                   #                    #                            #                   #         
                   #                    #                            #                   #        
                   #######################################################################        
                                                                                                    
																									