


                   #######################################################################
                   #                    #                            #                   #
                   #              B     #                                                #
                   #                    #                            #                   #
                   #                    #                            #                   #
                   ############ ############ #################### #################### ###
                   #                    #                            #                   #
                   #                                                 #                   #
                   #                    #                            #                   #
                   #                    #                            #                   #
                   ############ ##################### ##################### ##############
                   #                    #                            #                   #
                   #                    #                            #                   #
                   #                    #                            #                   #
                   ########### ############################# ########################## ##
                   #                    #                            #                   #
                   #                                                 #                   #
                   #                    #                            #          A        #
                   #                    #                                                #
                   #                    #                            #                   #
	               #                                                 #                   #
                   #                    #                            #                   #
                   #######################################################################
