                                                                                                                    
                                                           ..............................B                          
                                                           .######################################                  
                                                           .#                                    #                  
                                                           .#                                    #                  
             ...............................................#                                    #                  
             .###############################################                                    #                  
             .                                                                                   #                  
           ...                                                                                   #                  
           .#                                                                                    #                  
           .#                                                                                    #                  
           .#                                                                                    #                  
           .#                                                                                    #                  
           .#                                                                                    #                  
           .#################################################################                    #                  
           .#                                                                                    #                  
           .#                                                                                    #                  
           .#                                                                                    #                  
           .#                                                                                    #                  
           .#                                                                                    #                  
           .#                                                                                    #                  
           .#                                                                                    #                  
............#                                                                                    #                  
.###################################################################################################                
............................................................................                                        
                                                                           .                                        
                                                                           .                                        
                                                                           .                                        
                                                                           .                                        
                                                                           .                                        
                                                                           .                                        
                                                                           .                                        
                                                                           .                                        
                                                                           .                                        
                                                                           .                                        
                                                                           .                                        
                                                                           .                                        
                                                                           .                                        
                                                                           .###########                             
                                                                           .#         #                             
                                                                           .#         #                             
                                                                           .#  .A     #                             
                                                                           .#  .      #                             
                                                                           .#  .      #                             
                                                                           .###.  #####                             
                                                                           .....                                    
                                                                                                                    
                                                                                                                    