                                                                                                 
                                                                                                 
                                                                                                 
                   ############### #######################################################       
                   #                    #                            #                   #       
                   #             .B     #                                                #       
                   #             .      #                            #                   #       
                   #          ....      #                            #                   #       
                   ###########.############# #################### #################### ###       
                   #          ..........#                            #                   #       
                   #                   ...                           #                   #       
                   #                    #.                           #                   #       
                   #                    #.............               #                   #       
                   ############ #####################.##################### ##############       
                   #                    #            .               #                   #       
                   #                    #            .               #                   #       
                   #                    #            ........        #                   #        
                   ########### #############################.#################### ########        
                   #                    #                   .        #                   #        
                   #                                        .        #                   #        
                   #                    #                   .        #..........A                 
                   #                    #                   .        #.                  #        
                   #                    #                   ...........                  #       
                   #                                                 #                   #         
                   #                    #                            #                   #        
                   #######################################################################        
                                                                                                    
																									