                                                                                                                    
                                                                                         B                          
                                                            ######################################                  
                                                            #                                    #                  
                                                            #                                    #                  
                                                            #                                    #                  
              ###############################################                                    #                  
                                                                                                 #                  
                                                                                                 #                  
            #                                                                                    #                  
            #                                                                                    #                  
            #                                                                                    #                  
            #                                                                                    #                  
            #                                                                                    #                  
            #################################################################                    #                  
            #                                                                                    #                  
            #                                                                                    #                  
            #                                                                                    #                  
            #                                                                                    #                  
            #                                                                                    #                  
            #                                                                                    #                  
            #                                                                                    #                  
            #                                                                                    #                  
 ###################################################################################################                
                                                                                                                    
                                                                                                                    
                                                                                                                    
                                                                                                                    
                                                                                                                    
                                                                                                                    
                                                                                                                    
                                                                                                                    
                                                                                                                    
                                                                                                                    
                                                                                                                    
                                                                                                                    
                                                                                                                    
                                                                                                                    
                                                                            ###########                             
                                                                            #         #                             
                                                                            #         #                             
                                                                            #   A     #                             
                                                                            #         #                             
                                                                            #         #                             
                                                                            ###   #####                             
                                                                                                                    
                                                                                                                    
                                                                                                                    