                                                                                                 
                                                                                                 
                                                                                                 
                   ############### #######################################################       
                   #                    #                            #                   #       
                   #                    #                                                #       
                   #                    #                            #                   #       
                   #                    #                            #                   #       
                   ########### ############# #################### #################### ###       
                   #                    #                            #                   #       
                   #                                                 #                   #       
                   #                    #                            #                   #       
                   #                    #                            #                   #       
                   ############ ##################### ##################### ##############       
                   #                    #                            #                   #       
                   #                    #                            #                   #       
                   #                    #                            #                   #        
                   ########### ############################# #################### ########        
                   #                    #                            #                   #        
                   #                                                 #                   #        
                   #                    #                            #                            
                   #                    #                            #                   #        
                   #                    #                                                #       
                   #                                                 #                   #         
                   #                    #                            #                   #        
                   #######################################################################        
                                                                                                    
																									